15
2,2,2,2,2,3,3,1,4,1
0,0,0,0,0,0,0,0,0,0
0,0,0,0,0,0,0,0,0,0
0,0,0,0,1,1,0,0,1,0
1,1,1,1,1,1,1,0,1,0
1,1,1,1,0,1,1,1,1,1
0,0,0,0,0,0,1,0,1,0
0,0,0,0,0,0,0,0,0,0
0,0,0,0,0,0,0,0,0,0