19
2,2,2,4,1,1,1,2,1,5
0,0,0,0,0,0,0,0,0,0
0,0,0,0,0,0,0,0,0,0
0,0,1,1,0,0,0,0,0,1
1,1,1,1,1,1,1,1,1,1
1,1,0,1,0,0,0,1,0,1
0,0,0,1,0,0,0,0,0,1
0,0,0,0,0,0,0,0,0,1
0,0,0,0,0,0,0,0,0,0