25
1,1,1,6,1,1,1,5,1,7
0,0,0,0,0,0,0,0,0,1
0,0,0,1,0,0,0,1,0,1
0,0,0,1,0,0,0,1,0,1
0,0,0,1,0,0,0,1,0,1
1,1,1,1,1,1,1,1,1,1
0,0,0,1,0,0,0,1,0,1
0,0,0,1,0,0,0,0,0,1
0,0,0,0,0,0,0,0,0,0