1
5,5,5,5,5,4,4,4,4,3
0,0,0,0,0,0,0,0,0,0
1,1,1,1,1,0,0,0,0,0
1,1,1,1,1,1,1,1,1,0
1,1,1,1,1,1,1,1,1,1
1,1,1,1,1,1,1,1,1,1
1,1,1,1,1,1,1,1,1,1
0,0,0,0,0,0,0,0,0,0
0,0,0,0,0,0,0,0,0,0