17
1,1,3,3,5,4,2,1,2,2
0,0,0,0,1,0,0,0,0,0
0,0,0,0,1,1,0,0,0,1
0,0,0,0,1,1,1,1,1,1
0,0,0,1,1,1,1,0,1,0
0,0,0,1,1,1,0,0,0,0
0,0,1,1,0,0,0,0,0,0
0,0,1,0,0,0,0,0,0,0
1,1,1,0,0,0,0,0,0,0