24
5,6,5,4,3,2,1,1,1,1
0,1,0,0,0,0,0,0,0,0
1,1,0,0,0,0,0,0,0,0
1,1,0,1,1,0,0,0,0,0
1,1,1,1,1,1,1,1,1,1
1,1,1,1,1,1,0,0,0,0
1,1,1,1,0,0,0,0,0,0
0,0,1,0,0,0,0,0,0,0
0,0,1,0,0,0,0,0,0,0