22
5,1,6,2,3,3,5,1,2,1
0,0,0,0,0,0,0,0,0,0
0,0,1,0,1,0,1,0,0,0
0,0,1,1,1,1,1,0,0,0
1,1,1,1,1,1,1,0,0,0
1,0,1,0,0,1,1,0,1,1
1,0,1,0,0,0,1,1,1,0
1,0,1,0,0,0,0,0,0,0
1,0,0,0,0,0,0,0,0,0