7
3,3,4,3,3,4,2,2,1,1
0,0,0,0,0,0,0,0,0,0
0,1,1,0,1,1,0,0,0,0
1,1,1,1,1,1,1,1,1,1
1,1,1,1,1,1,1,1,0,0
1,0,1,1,0,1,0,0,0,0
0,0,0,0,0,0,0,0,0,0
0,0,0,0,0,0,0,0,0,0
0,0,0,0,0,0,0,0,0,0